---------------------------
HTML Справочник всех тегов:
---------------------------


---------------------------------------------------------------------------------------------------------------------------------------------------------------------------------------------

-----
Теги:
-----

<!--...-->	                                               --- Определяет комментарий
<!DOCTYPE> 	                                               --- Определяет тип документа

<a>	                                                       --- Определяет гиперссылку
<abbr>	                                                   --- Определяет аббревиатуру или акроним
<acronym>	                                                 --- Не поддерживается в HTML5. Использовать <abbr> Вместо. Определяет акроним
<address>	                                                 --- Определяет контактные данные автора/владельца документа
<applet>	                                                 --- Не поддерживается в HTML5. Использовать <embed> or <object> Вместо. Определяет встроенный апплет
<area>	                                                   --- Определяет область внутри изображения-карты
<article>	                                                 --- Определяет статью
<aside>	                                                   --- Определяет содержание в стороне от содержимого страницы
<audio>	                                                   --- Определяет звуковое содержимое
<b>	                                                       --- Определяет полужирный текст
<base>	                                                   --- Указывает базовый URL-адрес/цель для всех относительных URL-адресов в документе
<basefont>	                                               --- Не поддерживается в HTML5. Вместо этого используйте CSS. Задает цвет, размер и шрифт по умолчанию для всего текста в документе
<bdi>	                                                     --- Изолирует часть текста, которая может быть отформатирована в другом направлении от другого текста за его пределами
<bdo>	                                                     --- Переопределяет текущее направление текста
<big>	                                                     --- Не поддерживается в HTML5. Вместо этого используйте CSS. Определяет большой текст
<blockquote>	                                             --- Определяет раздел, который цитируется из другого источника
<body>	                                                   --- Определяет тело документа
<br>	                                                     --- Определяет один разрыв строки
<button>	                                                 --- Определяет нажатую кнопку
<canvas>	                                                 --- Используется для рисования графики, на лету, с помощью сценариев (обычно JavaScript)
<caption>	                                                 --- Определяет заголовок таблицы
<center>	                                                 --- Не поддерживается в HTML5. Вместо этого используйте CSS. Определяет центрированный текст
<cite>	                                                   --- Определяет название работы
<code>	                                                   --- Определяет часть кода компьютера
<col>	                                                     --- Задает свойства столбца для каждого столбца в <colgroup> element
<colgroup>	                                               --- Задает группу из одного или нескольких столбцов в таблице для форматирования
<data>	                                                   --- Связывает данное содержимое с машинно-читаемым переводом
<datalist>	                                               --- Задает список предварительно заданных параметров для элементов управления вводом
<dd>	                                                     --- Определяет описание/значение термина в списке описания
<del>	                                                     --- Определяет текст, который был удален из документа
<details>	                                                 --- Определяет дополнительные сведения, которые пользователь может просматривать или скрывать
<dfn>	                                                     --- Представляет определяющий экземпляр термина
<dialog>	                                                 --- Определяет диалоговое окно или окно
<dir>	                                                     --- Не поддерживается в HTML5. Использовать <ul> Вместо. Определяет список каталогов
<div>	                                                     --- Определяет раздел в документе
<dl>	                                                     --- Определяет список описания
<dt>	                                                     --- Определяет термин/имя в списке описания
<em>	                                                     --- Определяет подчеркнутый текст
<embed>	                                                   --- Определяет контейнер для внешнего (не HTML) приложения
<fieldset>	                                               --- Группирует связанные элементы в форме
<figcaption>	                                             --- Определяет заголовок для <figure> Элемент
<figure>	                                                 --- Указывает автономное содержимое
<font>	                                                   --- Не поддерживается в HTML5. Вместо этого используйте CSS. Определяет шрифт, цвет и размер текста
<footer>	                                                 --- Определяет нижний колонтитул для документа или раздела
<form>	                                                   --- Определяет HTML-форму для ввода данных пользователем
<frame>	                                                   --- Не поддерживается в HTML5. Определяет окно (фрейм) в фрейме
<frameset>	                                               --- Не поддерживается в HTML5. Определяет набор фреймов
<h1> to <h6>	                                             --- Определяет заголовки HTML
<head>	                                                   --- Определяет сведения о документе
<header>	                                                 --- Определяет заголовок документа или раздела
<hr>	                                                     --- Определяет тематическое изменение содержания
<html>	                                                   --- Определяет корень HTML-документа
<i>	                                                       --- Определяет часть текста в альтернативный голос или настроение
<iframe>	                                                 --- Определяет встроенный фрейм
<img>	                                                     --- Определяет изображение
<input>	                                                   --- Определяет элемент управления вводом
<ins>	                                                     --- Определяет текст, вставленный в документ
<kbd>	                                                     --- Определяет ввод с клавиатуры
<label>	                                                   --- Определяет метку для <input> Элемент
<legend>	                                                 --- Определяет заголовок для <fieldset> Элемент
<li>	                                                     --- Определяет элемент списка
<link>	                                                   --- Определяет связь между документом и внешним ресурсом (наиболее используемым для связывания с таблицами стилей)
<main>	                                                   --- Указывает основное содержимое документа
<map>	                                                     --- Определяет изображение на стороне клиента-Map
<mark>	                                                   --- Определяет выделенный/выделенный текст
<menu>	                                                   --- Определяет список/меню команд
<menuitem>	                                               --- Определяет команду/пункт меню, который пользователь может вызвать из всплывающего меню
<meta>	                                                   --- Определяет метаданные HTML-документа
<meter>	                                                   --- Определяет скалярное измерение в пределах известного диапазона (датчика)
<nav>	                                                     --- Определяет навигационные ссылки
<noframes>	                                               --- Не поддерживается в HTML5. Определяет альтернативное содержимое для пользователей, которые не поддерживают кадры
<noscript>	                                               --- Определяет альтернативное содержимое для пользователей, которые не поддерживают сценарии на стороне клиента
<object>	                                                 --- Определяет внедренный объект
<ol>	                                                     --- Определяет упорядоченный список
<optgroup>	                                               --- Определяет группу связанных параметров в раскрывающемся списке
<option>	                                                 --- Определяет параметр в раскрывающемся списке
<output>	                                                 --- Определяет результат вычисления
<p>	                                                       --- Определяет абзац
<param>	                                                   --- Определяет параметр для объекта
<picture>	                                                 --- Определяет контейнер для нескольких ресурсов изображения
<pre>	                                                     --- Определяет предварительно отформатированный текст
<progress>	                                               --- Представляет ход выполнения задачи
<q>	                                                       --- Определяет краткое предложение
<rp>	                                                     --- Определяет, что отображать в обозревателях, не поддерживающих аннотации Ruby
<rt>	                                                     --- Определяет объяснение/произношение символов (для восточно-азиатских типографии)
<ruby>	                                                   --- Определяет аннотацию Ruby (для восточно-азиатских типографий)
<s>	                                                       --- Определяет текст, который больше не является правильным
<samp>	                                                   --- Определяет выборку выходных данных из компьютерной программы
<script>	                                                 --- Определяет сценарий на стороне клиента
<section>	                                                 --- Определяет раздел в документе
<select>	                                                 --- Определяет раскрывающийся список
<small>	                                                   --- Определяет меньший текст
<source>	                                                 --- Определяет несколько мультимедийных ресурсов для элементов мультимедиа (<video> И <audio>)
<span>	                                                   --- Определяет раздел в документе
<strike>	                                                 --- Не поддерживается в HTML5. Использовать <del> или <s> Вместо. Определяет текст зачеркивания
<strong>	                                                 --- Определяет важный текст
<style>	                                                   --- Определяет сведения о стиле для документа
<sub>	                                                     --- Определяет текст с подстрочным текстом
<summary>	                                                 --- Определяет видимый заголовок для <details> Элемента
<sup>	                                                     --- Определяет текст с надписью
<svg>	                                                     --- Определяет контейнер для графики SVG
<table>	                                                   --- Определяет таблицу
<tbody>	                                                   --- Группирует содержимое тела в таблице
<td>	                                                     --- Определяет ячейку в таблице
<template>	                                               --- Определяет шаблон
<textarea>	                                               --- Определяет многострочный элемент управления вводом (область текста)
<tfoot>	                                                   --- Группирует содержимое нижнего колонтитула в таблице
<th>	                                                     --- Определяет ячейку заголовка в таблице
<thead>	                                                   --- Группирует содержимое заголовка в таблице
<time>	                                                   --- Определяет дату и время
<title>	                                                   --- Определяет заголовок документа
<tr>	                                                     --- Определяет строку в таблице
<track>	                                                   --- Определяет текстовые дорожки для элементов мультимедиа (<video> И <audio>)
<tt>	                                                     --- Не поддерживается в HTML5. Вместо этого используйте CSS. Определяет телетайп текст
<u>	                                                       --- Определяет текст, который должен быть стилистически отличается от обычного текста
<ul>	                                                     --- Определяет неупорядоченный список
<var>	                                                     --- Определяет переменную
<video>	                                                   --- Определяет видео или фильм
<wbr>	                                                     --- Определяет возможный разрыв строки


---------------------------------------------------------------------------------------------------------------------------------------------------------------------------------------------

---------------------
HTML Атрибуты Ссылки:
---------------------

accept	        <input>	                                   --- Указывает типы файлов, которые принимает сервер (только для type="file")
accept-charset	<form>	                                   --- Задает кодировки символов, которые должны использоваться для отправки формы
accesskey	      Global Attributes	                         --- Задает комбинацию клавиш для активации/фокусировки элемента
action	        <form>	                                   --- Указывает, куда отправлять форму-данные при отправке формы
alt	            <area>, <img>, <input>	                   --- Задает альтернативный текст при неудачном отображении исходного элемента
async	          <script>	                                 --- Указывает, что сценарий выполняется асинхронно (только для внешних скриптов)
autocomplete	  <form>, <input>	                           --- Указывает, является ли <form> или <input> элемент должен иметь Автозаполнение включено
autofocus	      <button>, <input>, <select>, <textarea>	   --- Указывает, что элемент должен автоматически получать фокус при загрузке страницы
autoplay	      <audio>, <video>	                         --- Указывает, что воспроизведение аудио/видео начнется сразу после его готовности
charset	        <meta>, <script>	                         --- Задает кодировку символов
checked	        <input>	                                   --- Указывает, что <input> элемент должен быть предварительно выбран при загрузке страницы (Для type="checkbox" или type="radio")
cite	          <blockquote>, <del>, <ins>, <q>	           --- Указывает URL-адрес, объясняющий quote/deleted/inserted text
class	          Global Attributes	                         --- Указывает одно или несколько классов для элемента (относится к классу в таблице стилей)
cols	          <textarea>	                               --- Определяет видимую ширину текстовой области
colspan	        <td>, <th>	                               --- Указывает число столбцов, которые должна охватывать ячейка таблицы
content	        <meta>	                                   --- Дает значение, связанное с атрибутом http-equiv или Name
contenteditable	Global Attributes	                         --- Указывает, является ли содержимое элемента редактируемым или нет
contextmenu	    Global Attributes	                         --- Задает контекстное меню для элемента. Контекстное меню появляется, когда пользователь щелкает правой кнопкой мыши по элементу
controls	      <audio>, <video>	                         --- Указывает, что должны отображаться элементы управления аудио/видео (например, кнопка воспроизведения/паузы и т. д.)
coords	        <area>	                                   --- Задание координат области
data	          <object>	                                 --- Указывает URL-адрес ресурса, используемого объектом
data-*	        Global Attributes	                         --- Используется для хранения пользовательских данных, закрытых для страницы или приложения
datetime	      <del>, <ins>, <time>	                     --- Указывает дату и время
default	        <track>	                                   --- Указывает, что дорожка должна быть включена, если предпочтения пользователя не указывают на то, что другая дорожка будет более подходящей
defer	          <script>	                                 --- Указывает, что сценарий выполняется после завершения синтаксического анализа страницы (только для внешних скриптов)
dir	            Global Attributes	                         --- Задает направление текста для содержимого в элементе
dirname	        <input>, <textarea>	                       --- Указывает, что направление текста будет отправлено
disabled	      <button>, <fieldset>, <input>, <optgroup>,
                <option>, <select>, <textarea>             --- Указывает, что указанный элемент/Группа элементов должна быть отключена
download	      <a>, <area>	                               --- Указывает, что целевой объект будет загружен, когда пользователь щелкнет гиперссылку
draggable	      Global Attributes	                         --- Указывает, является ли элемент перетаскивается или нет
dropzone	      Global Attributes	                         --- Указывает, копируются ли перенесенные данные, перемещаются ли они и связаны ли они при удалении
enctype	        <form>	                                   --- Указывает, как данные формы должны кодироваться при отправке на сервер (только для method="post")
for	            <label>, <output>	                         --- Указывает, к какому элементу (ам) формы привязана метка/вычисление
form	          <button>, <fieldset>, <input>, <label>,
                <meter>, <object>, <output>, <select>,
                <textarea>                                 --- Указывает имя формы, к которой принадлежит элемент
formaction	    <button>, <input>	                         --- Указывает, куда отправлять данные формы при отправке формы. Только для type="submit"
headers	        <td>, <th>	                               --- Указывает одну или несколько ячеек заголовков, связанных с ячейкой
height	        <canvas>, <embed>, <iframe>, <img>,
                <input>, <object>, <video>	               --- Задает высоту элемента
hidden	        Global Attributes	                         --- Указывает, что элемент еще не является или больше не является релевантным
high	          <meter>	                                   --- Указывает диапазон, который считается высоким значением
href	          <a>, <area>, <base>, <link>	               --- Указывает URL-адрес страницы, на которую переходит ссылка
hreflang	      <a>, <area>, <link>	                       --- Указывает язык связанного документа
http-equiv	    <meta>	                                   --- Предоставляет заголовок HTTP для информации/значения атрибута Content
id	            Global Attributes	                         --- Задает уникальный идентификатор для элемента
ismap	          <img>	                                     --- Определяет изображение как серверное изображение-Map
kind	          <track>	                                   --- Указывает тип текстовой дорожки
label	          <track>, <option>, <optgroup>	             --- Задает заголовок текстовой дорожки
lang	          Global Attributes	                         --- Указывает язык содержимого элемента
list	          <input>	                                   --- Ссылается на элемент <DataList>, содержащий предварительно определенные параметры для элемента <input>
loop	          <audio>, <video>	                         --- Указывает, что аудио/видео будет начинаться снова, каждый раз, когда он закончится
low	            <meter>	                                   --- Указывает диапазон, который считается низким значением
max	            <input>, <meter>, <progress>	             --- Задает максимальное значение
maxlength	      <input>, <textarea>	                       --- Указывает максимальное число символов, разрешенных в элементе
media	          <a>, <area>, <link>, <source>, <style>	   --- Указывает, какие носители/устройства оптимизированы для связанного документа
method	        <form>	                                   --- Указывает метод HTTP, используемый при отправке данных формы
min	            <input>, <meter>	                         --- Задает минимальное значение
multiple	      <input>, <select>	                         --- Указывает, что пользователь может ввести более одного значения
muted	          <video>, <audio>	                         --- Указывает, что аудиовыход видео должен быть отключен
name	          <button>, <fieldset>, <form>, <iframe>,
                <input>, <map>, <meta>, <object>,
                <output>, <param>, <select>, <textarea>	   --- Задает имя элемента
novalidate	    <form>	                                   --- Указывает, что форма не должна проверяться при отправке
onabort	        <audio>, <embed>, <img>, <object>,
                <video>	                                   --- Сценарий, запускаемый при прерывании
onafterprint	  <body>	                                   --- Сценарий, запускаемый после печати документа
onbeforeprint	  <body>	                                   --- Выполнение сценария перед печатью документа
onbeforeunload	<body>	                                   --- Сценарий, запускаемый при выгрузке документа
onblur	        All visible elements.	                     --- Сценарий, запускаемый при потере фокуса элементом
oncanplay	      <audio>, <embed>, <object>, <video>	       --- Скрипт будет запущен, когда файл готов к началу воспроизведения конца без паузы для буферизации
onchange	      All visible elements.	                     --- Сценарий, запускаемый при изменении значения элемента
onclick	        All visible elements.	                     --- Сценарий, запускаемый при щелчке элемента
oncontextmenu	  All visible elements.	                     --- Сценарий, запускаемый при запуске контекстного меню
oncopy	        All visible elements.	                     --- Сценарий, запускаемый при копировании содержимого элемента
oncuechange	    <track>	                                   --- Скрипт запускается, когда кий изменяется в <track> element
oncut	          All visible elements.	                     --- Сценарий, запускаемый при вырезании содержимого элемента
ondblclick	    All visible elements.	                     --- Сценарий, запускаемый при двойном щелчке элемента
ondrag	        All visible elements.	                     --- Сценарий, запускаемый при перетаскивании элемента
ondragend	      All visible elements.	                     --- Сценарий, запускаемый в конце операции перетаскивания
ondragenter	    All visible elements.	                     --- Сценарий, запускаемый при перетаскивании элемента в допустимый целевой объект перетаскивания
ondragleave	    All visible elements.	                     --- Сценарий, запускаемый, когда элемент оставляет допустимый целевой объект перетаскивания
ondragover	    All visible elements.	                     --- Сценарий, запускаемый при перетаскивании элемента над допустимым целевым объектом перетаскивания
ondragstart	    All visible elements.	                     --- Сценарий, запускаемый в начале операции перетаскивания
ondrop	        All visible elements.	                     --- Сценарий, запускаемый при удалении перетаскивания элемента
onemptied	      <audio>, <video>	                         --- Скрипт для запуска, когда что-то плохое происходит, и файл внезапно недоступен (как неожиданно отключается)
onended	        <audio>, <video>	                         --- Скрипт будет запущен, когда носитель достигнет конца (полезное событие для сообщений, таких как "Спасибо за прослушивание")
onerror	        <audio>, <body>, <embed>, <img>, <object>,
                <script>, <style>, <video>	               --- Сценарий, запускаемый при возникновении ошибки
onfocus	        All visible elements.	                     --- Сценарий, запускаемый, когда элемент получает фокус
onhashchange	  <body>	                                   --- Сценарий, который должен быть запущен, когда были внесены изменения в якорную часть


---------------------------------------------------------------------------------------------------------------------------------------------------------------------------------------------

-----------
URL-адреса:
-----------

oninput	           All visible elements.	                 --- Сценарий, запускаемый, когда элемент получает пользовательский ввод
oninvalid	         All visible elements.	                 --- Сценарий, запускаемый при недопустимом элементе
onkeydown	         All visible elements.	                 --- Сценарий, запускаемый при нажатии пользователем клавиши
onkeypress	       All visible elements.	                 --- Сценарий, запускаемый при нажатии пользователем клавиши
onkeyup	           All visible elements.	                 --- Сценарий, запускаемый, когда пользователь освобождает ключ
onload	           <body>, <iframe>, <img>, <input>,
                   <link>, <script>, <style>	             --- Сценарий, запускаемый при завершении загрузки элемента
onloadeddata	     <audio>, <video>	                       --- Сценарий, запускаемый при загрузке мультимедийных данных
onloadedmetadata	 <audio>, <video>	                       --- Скрипт, запускаемый при загрузке мета-данных (таких как размеры и длительность)
onloadstart	       <audio>, <video>	                       --- Сценарий для запуска так же, как файл начинает загружаться, прежде чем что-либо на самом деле загружен
onmousedown	       All visible elements.	                 --- Сценарий, запускаемый при нажатии кнопки мыши на элементе
onmousemove	       All visible elements.	                 --- Сценарий будет выполняться до тех пор, пока указатель мыши &нбсп; перемещается над элементом
onmouseout	       All visible elements.	                 --- Сценарий, запускаемый при перемещении указателя мыши из элемента
onmouseover	       All visible elements.	                 --- Сценарий, запускаемый при перемещении указателя мыши над элементом
onmouseup	         All visible elements.	                 --- Сценарий, запускаемый при отпускании кнопки мыши над элементом
onmousewheel	     All visible elements.	                 --- Сценарий, запускаемый при прокрутке колесика мыши над элементом
onoffline	         <body>	                                 --- Скрипт, запускаемый при запуске браузера для работы в автономном режиме
ononline	         <body>	                                 --- Сценарий, запускаемый при запуске браузера для работы в Интернете
onpagehide	       <body>	                                 --- Сценарий для запуска, когда пользователь переходит от страницы
onpageshow	       <body>	                                 --- Сценарий, запускаемый при переходе пользователя на страницу
onpaste	           All visible elements.	                 --- Сценарий, запускаемый при вставке пользователем некоторого содержимого в элемент
onpause	           <audio>, <video>	                       --- Сценарий, запускаемый при приостановлении работы носителя пользователем или программным способом
onplay	           <audio>, <video>	                       --- Сценарий, запускаемый после начала воспроизведения мультимедиа
onplaying	         <audio>, <video>	                       --- Сценарий, запускаемый после начала воспроизведения мультимедиа
onpopstate	       <body>	                                 --- Скрипт, запускаемый при изменении истории окна.
onprogress	       <audio>, <video>	                       --- Скрипт для запуска, когда браузер находится в процессе получения мультимедийных данных
onratechange	     <audio>, <video>	                       --- Скрипт будет выполняться каждый раз при изменении частоты воспроизведения
onreset	           <form>	                                 --- Сценарий, запускаемый при нажатии кнопки сброса в форме.
onresize	         <body>	                                 --- Сценарий, запускаемый при изменении размера окна обозревателя.
onscroll	         All visible elements.	                 --- Сценарий, запускаемый при прокрутке полосы прокрутки элемента
onsearch	         <input>	                               --- Script для запуска, когда пользователь пишет что-то в поле поиска (Для <input="search">)
onseeked	         <audio>, <video>	                       --- Сценарий, запускаемый, когда атрибуту поиска присваивается значение false, указывающее, что Поиск завершен
onseeking	         <audio>, <video>	                       --- Сценарий, запускаемый, когда атрибуту поиска присваивается значение true, указывающее, что поиск активен
onselect	         All visible elements.	                 --- Сценарий, запускаемый при выборе элемента
onshow	           <menu>	                                 --- Скрипт, запускаемый при <menu> элемент отображается в виде контекстного меню
onstalled	         <audio>, <video>	                       --- Скрипт для запуска, когда браузер не может получить данные мультимедиа по какой-либо причине
onstorage	         <body>	                                 --- Сценарий, запускаемый при обновлении области веб-хранилища
onsubmit	         <form>	                                 --- Сценарий, запускаемый при отправке формы
onsuspend	         <audio>, <video>	                       --- Скрипт, запускаемый при извлечении мультимедийных данных, останавливается до полной загрузки по какой-либо причине
ontimeupdate	     <audio>, <video>	                       --- Скрипт, запускаемый при изменении игрового положения (например, когда пользователь пересылается в другую точку носителя)
ontoggle	         <details>	                             --- Сценарий, запускаемый, когда пользователь открывает или закрывает элемент < Details >
onunload	         <body>	                                 --- Скрипт, запускаемый при выгрузке страницы (или закрытии окна браузера)
onvolumechange	   <audio>, <video>	                       --- Скрипт будет выполняться каждый раз при изменении громкости видео/аудио
onwaiting	         <audio>, <video>	                       --- Сценарий, запускаемый, когда носитель приостановлен, но ожидается его возобновление
onwheel	           All visible elements.	                 --- Скрипт для запуска, когда колесо мыши катится вверх или вниз над элементом
open	             <details>	                             --- Указывает, что сведения должны быть видимыми (открытыми) для использования
optimum	           <meter>	                               --- Определяет, какое значение является оптимальным для датчика
pattern	           <input>	                               --- Задает регулярное выражение, которое <input> значение элемента проверяется
placeholder	       <input>, <textarea>	                   --- Задает краткую подсказку, описывающую ожидаемое значение элемента
poster	           <video>	                               --- Указывает изображение, которое будет отображаться во время загрузки видео, или до тех пор, пока пользователь не достигнет кнопки воспроизведения
preload	           <audio>, <video>	                       --- Указывает, если и как автор считает, что аудио/видео должно быть загружено при загрузке страницы
readonly	         <input>, <textarea>	                   --- Указывает, что элемент является только для чтения
rel	               <a>, <area>, <link>	                   --- Указывает связь между текущим документом и связанным документом
required	         <input>, <select>, <textarea>	         --- Указывает, что элемент должен быть заполнен до отправки формы
reversed	         <ol>	                                   --- Указывает, что порядок списков должен быть по убыванию (9,8,7...)
rows	             <textarea>	                             --- Указывает видимое число строк в текстовой области
rowspan	           <td>, <th>	                             --- Указывает количество строк, которые должна охватывать ячейка таблицы
sandbox	           <iframe>	                               --- Включает дополнительный набор ограничений для содержимого в <iframe>
scope	             <th>	                                   --- Указывает, является ли ячейка заголовка столбцом, строкой или группой столбцов или строк
selected	         <option>	                               --- Указывает, что параметр должен быть предварительно выбран при загрузке страницы
shape	             <area>	                                 --- Определяет форму области
size	             <input>, <select>	                     --- Задает ширину, в символах (для <input>) или задает количество видимых параметров (Для <select>)
sizes	             <img>, <link>, <source>	               --- Задает размер связанного ресурса
span	             <col>, <colgroup>	                     --- Указывает количество столбцов для span
spellcheck	       Global Attributes	                     --- Признак проверки орфографии и грамматики элемента
src	               <audio>, <embed>, <iframe>, <img>,
                   <input>, <script>, <source>, <track>,
                   <video>                                 --- Указывает URL-адрес файла мультимедиа
srcdoc	           <iframe>	                               --- Задает HTML-содержимое страницы, которая отображается в <iframe>
srclang	           <track>	                               --- Указывает язык текстовых данных дорожки (required if kind="subtitles")
srcset	           <img>, <source>	                       --- Указывает URL-адрес изображения для использования в различных ситуациях
start	             <ol>	                                   --- Задает начальное значение упорядоченного списка
step	             <input>	                               --- Задает юридические интервалы номеров для поля ввода
style	             Global Attributes	                     --- Задает встроенный стиль CSS для элемента
tabindex	         Global Attributes	                     --- Задает порядок табуляции элемента
target	           <a>, <area>, <base>, <form>	           --- Указывает целевой объект для открытия связанного документа или места отправки формы
title	             Global Attributes	                     --- Указывает дополнительные сведения об элементе
translate	         Global Attributes	                     --- Указывает, должно ли содержимое элемента быть переведено или нет
type	             <button>, <embed>, <input>,
                   <link>, <menu>, <object>, <script>,
                   <source>, <style>                       --- Указывает тип элемента
usemap	           <img>, <object>	                       --- Указывает изображение в виде клиентского изображения-карты
value	             <button>, <input>, <li>, <option>,
                   <meter>, <progress>, <param>	           --- Задает значение элемента
width	             <canvas>, <embed>, <iframe>, <img>,
                   <input>, <object>, <video>	             --- Задает ширину элемента
wrap	             <textarea>	                             --- Указывает, как текст в текстовой области должен быть упакован при отправке в форме



---------------------------------------------------------------------------------------------------------------------------------------------------------------------------------------------

-------------------------
HTML Глобальные атрибуты:
-------------------------

accesskey	                                                 --- Задает комбинацию клавиш для активации/фокусировки элемента
class	                                                     --- Указывает одно или несколько классов для элемента (относится к классу в таблице стилей)
contenteditable	                                           --- Указывает, является ли содержимое элемента редактируемым или нет
contextmenu	                                               --- Задает контекстное меню для элемента. Контекстное меню появляется, когда пользователь щелкает правой кнопкой мыши по элементу
data-*	                                                   --- Используется для хранения пользовательских данных, закрытых для страницы или приложения
dir	                                                       --- Задает направление текста для содержимого в элементе
draggable	                                                 --- Указывает, является ли элемент перетаскивается или нет
dropzone	                                                 --- Указывает, копируются ли перенесенные данные, перемещаются ли они и связаны ли они при удалении
hidden	                                                   --- Указывает, что элемент еще не является или больше не является релевантным
id	                                                       --- Задает уникальный идентификатор для элемента
lang	                                                     --- Указывает язык содержимого элемента
spellcheck	                                               --- Признак проверки орфографии и грамматики элемента
style	                                                     --- Задает встроенный стиль CSS для элемента
tabindex	                                                 --- Задает порядок табуляции элемента
title	                                                     --- Указывает дополнительные сведения об элементе
translate	                                                 --- Указывает, должно ли содержимое элемента быть переведено или нет



---------------------------------------------------------------------------------------------------------------------------------------------------------------------------------------------

----------------------
Атрибуты события окна:
----------------------

onafterprint	  script	                                   --- Сценарий, запускаемый после печати документа
onbeforeprint	  script	                                   --- Выполнение сценария перед печатью документа
onbeforeunload	script	                                   --- Сценарий, запускаемый при выгрузке документа
onerror	        script	                                   --- Сценарий, запускаемый при возникновении ошибки
onhashchange	  script	                                   --- Сценарий, который должен быть запущен, когда были внесены изменения в якорную часть URL-адреса
onload	        script	                                   --- Срабатывает после завершения загрузки страницы
onmessage	      script	                                   --- Сценарий, запускаемый при срабатывании сообщения
onoffline	      script	                                   --- Скрипт, запускаемый при запуске браузера для работы в автономном режиме
ononline	      script	                                   --- Сценарий, запускаемый при запуске браузера для работы в Интернете
onpagehide	    script	                                   --- Сценарий для запуска, когда пользователь переходит от страницы
onpageshow	    script	                                   --- Сценарий, запускаемый при переходе пользователя на страницу
onpopstate	    script	                                   --- Сценарий, запускаемый при изменении истории окна
onresize	      script	                                   --- Срабатывает при изменении размера окна обозревателя
onstorage	      script	                                   --- Сценарий, запускаемый при обновлении области веб-хранилища
onunload	      script	                                   --- Срабатывает после того, как страница выгружена (или окно браузера закрыто)



---------------------------------------------------------------------------------------------------------------------------------------------------------------------------------------------

--------------
События формы:
--------------


onblur	      script	                                     --- Запускает момент, когда элемент теряет фокус
onchange	    script	                                     --- Запускает момент, когда изменяется значение элемента
oncontextmenu	script	                                     --- Сценарий, запускаемый при запуске контекстного меню
onfocus	      script	                                     --- Запускает момент, когда элемент получает фокус
oninput	      script	                                     --- Сценарий, запускаемый, когда элемент получает пользовательский ввод
oninvalid	    script	                                     --- Сценарий, запускаемый при недопустимом элементе
onreset	      script	                                     --- Срабатывает при нажатии кнопки сброса в форме
onsearch	    script	                                     --- Срабатывает, когда пользователь пишет что-то в поле поиска (для <input="search">)
onselect	    script	                                     --- Срабатывает после выбора некоторого текста в элементе
onsubmit	    script	                                     --- Срабатывает при отправке формы



---------------------------------------------------------------------------------------------------------------------------------------------------------------------------------------------

-------------------
События клавиатуры:
-------------------

onkeydown	  script	                                       --- Срабатывает, когда пользователь нажимает клавишу
onkeypress	script	                                       --- Срабатывает, когда пользователь нажимает клавишу
onkeyup	    script	                                       --- Срабатывает, когда пользователь освобождает ключ



---------------------------------------------------------------------------------------------------------------------------------------------------------------------------------------------

-------------
События мыши:
-------------

onclick	      script	                                     --- Срабатывает при щелчке мышью по элементу
ondblclick	  script	                                     --- Срабатывает при двойном щелчке мышью по элементу
onmousedown	  script	                                     --- Срабатывает при нажатии кнопки мыши на элементе
onmousemove	  script	                                     --- Срабатывает, когда указатель мыши движется, находясь над элементом
onmouseout	  script	                                     --- Срабатывает, когда указатель мыши перемещается из элемента
onmouseover	  script	                                     --- Срабатывает, когда указатель мыши перемещается над элементом
onmouseup	    script	                                     --- Срабатывает при отпускании кнопки мыши над элементом
onmousewheel	script	                                     --- Устаревшие. Используйте onwheel вместо атрибута
onwheel	      script	                                     --- Срабатывает, когда колесо мыши катится вверх или вниз над элементом



---------------------------------------------------------------------------------------------------------------------------------------------------------------------------------------------

-----------------------
Перетаскивание событий:
-----------------------

ondrag	    script	                                       --- Сценарий, запускаемый при перетаскивании элемента
ondragend	  script	                                       --- Сценарий, запускаемый в конце операции перетаскивания
ondragenter	script	                                       --- Сценарий, запускаемый при перетаскивании элемента в допустимый целевой объект перетаскивания
ondragleave	script	                                       --- Сценарий, запускаемый, когда элемент оставляет допустимый целевой объект перетаскивания
ondragover	script	                                       --- Сценарий, запускаемый при перетаскивании элемента над допустимым целевым объектом перетаскивания
ondragstart	script	                                       --- Сценарий, запускаемый в начале операции перетаскивания
ondrop	    script	                                       --- Сценарий, запускаемый при удалении перетаскивания элемента
onscroll	  script	                                       --- Сценарий, запускаемый при прокрутке полосы прокрутки элемента



---------------------------------------------------------------------------------------------------------------------------------------------------------------------------------------------

----------------------
События буфера обмена:
----------------------

oncopy	script	                                           --- Срабатывает, когда пользователь копирует содержимое элемента
oncut	  script	                                           --- Срабатывает, когда пользователь режет содержимое элемента
onpaste	script	                                           --- Срабатывает, когда пользователь вставляет некоторое содержимое в элемент



---------------------------------------------------------------------------------------------------------------------------------------------------------------------------------------------

--------------
Медиа-события:
--------------

onabort	          script	                                 --- Сценарий, запускаемый при прерывании
oncanplay	        script	                                 --- Скрипт будет запущен, когда файл готов к началу воспроизведения (когда он достаточно буферизован, чтобы начать)
oncanplaythrough	script	                                 --- Сценарий для запуска, когда файл можно воспроизвести до конца без паузы для буферизации
oncuechange	      script	                                 --- Сценарий, запускаемый при изменении Кия в элементе <track>
ondurationchange	script	                                 --- Сценарий, запускаемый при изменении длины носителя
onemptied	        script	                                 --- Скрипт для запуска, когда что-то плохое происходит, и файл внезапно недоступен (как неожиданно отключается)
onended	          script	                                 --- Скрипт будет запущен, когда носитель достигнет конца (полезное событие для сообщений, таких как "Спасибо за прослушивание")
onerror	          script	                                 --- Сценарий, запускаемый при возникновении ошибки при загрузке файла
onloadeddata	    script	                                 --- Сценарий, запускаемый при загрузке мультимедийных данных
onloadedmetadata	script	                                 --- Скрипт, запускаемый при загрузке мета-данных (таких как размеры и длительность)
onloadstart	      script	                                 --- Сценарий для запуска так же, как файл начинает загружаться, прежде чем что-либо на самом деле загружен
onpause	          script	                                 --- Сценарий, запускаемый при приостановлении работы носителя пользователем или программным способом
onplay	          script	                                 --- Сценарий для запуска, когда носитель готов к началу воспроизведения
onplaying	        script	                                 --- Сценарий для запуска, когда носитель фактически начал воспроизведение
onprogress	      script	                                 --- Скрипт для запуска, когда браузер находится в процессе получения мультимедийных данных
onratechange	    script	                                 --- Скрипт будет выполняться каждый раз при изменении частоты воспроизведения указывающее, что Поиск завершен
onseeking	        script	                                 --- Сценарий, запускаемый, когда атрибуту поиска присваивается значение true, указывающее, что поиск активен
onstalled	        script	                                 --- Сценарий для запуска, когда обозреватель не может получить данные мультимедиа по какой-либо причине
onsuspend	        script	                                 --- Скрипт, запускаемый при извлечении мультимедийных данных, останавливается до полной загрузки по какой-либо причине
ontimeupdate	    script	                                 --- Скрипт, запускаемый при изменении игрового положения (например, когда пользователь пересылается в другую точку носителя)
onvolumechange	  script	                                 --- Скрипт, который будет выполняться каждый раз при изменении тома, который (включая настройку тома на "mute")
onwaiting	        script	                                 --- Сценарий, запускаемый, когда носитель приостановлен, но ожидается его возобновление



---------------------------------------------------------------------------------------------------------------------------------------------------------------------------------------------

---------------
Разные события:
---------------

onshow	          script	                                 --- Срабатывает, когда элемент <menu> отображается в виде контекстного меню
ontoggle	        script	                                 --- Срабатывает, когда пользователь открывает или закрывает элемент <details>



---------------------------------------------------------------------------------------------------------------------------------------------------------------------------------------------

-----------------
HTML Color Names:
-----------------


AliceBlue 	             #F0F8FF	 	Оттенки	Смесь
AntiqueWhite 	           #FAEBD7	 	Оттенки	Смесь
Aqua 	                   #00FFFF	 	Оттенки	Смесь
Aquamarine 	             #7FFFD4	 	Оттенки	Смесь
Azure 	                 #F0FFFF	 	Оттенки	Смесь
Beige 	                 #F5F5DC	 	Оттенки	Смесь
Bisque 	                 #FFE4C4	 	Оттенки	Смесь
Black 	                 #000000	 	Оттенки	Смесь
BlanchedAlmond 	         #FFEBCD	 	Оттенки	Смесь
Blue 	                   #0000FF	 	Оттенки	Смесь
BlueViolet 	             #8A2BE2	 	Оттенки	Смесь
Brown 	                 #A52A2A	 	Оттенки	Смесь
BurlyWood 	             #DEB887	 	Оттенки	Смесь
CadetBlue 	             #5F9EA0	 	Оттенки	Смесь
Chartreuse 	             #7FFF00	 	Оттенки	Смесь
Chocolate 	             #D2691E	 	Оттенки	Смесь
Coral 	                 #FF7F50	 	Оттенки	Смесь
CornflowerBlue 	         #6495ED	 	Оттенки	Смесь
Cornsilk 	               #FFF8DC	 	Оттенки	Смесь
Crimson 	               #DC143C	 	Оттенки	Смесь
Cyan 	                   #00FFFF	 	Оттенки	Смесь
DarkBlue 	               #00008B	 	Оттенки	Смесь
DarkCyan 	               #008B8B	 	Оттенки	Смесь
DarkGoldenRod 	         #B8860B	 	Оттенки	Смесь
DarkGray 	               #A9A9A9	 	Оттенки	Смесь
DarkGrey 	               #A9A9A9	 	Оттенки	Смесь
DarkGreen 	             #006400	 	Оттенки	Смесь
DarkKhaki 	             #BDB76B	 	Оттенки	Смесь
DarkMagenta 	           #8B008B	 	Оттенки	Смесь
DarkOliveGreen 	         #556B2F	 	Оттенки	Смесь
DarkOrange 	             #FF8C00	 	Оттенки	Смесь
DarkOrchid 	             #9932CC	 	Оттенки	Смесь
DarkRed 	               #8B0000	 	Оттенки	Смесь
DarkSalmon 	             #E9967A	 	Оттенки	Смесь
DarkSeaGreen 	           #8FBC8F	 	Оттенки	Смесь
DarkSlateBlue 	         #483D8B	 	Оттенки	Смесь
DarkSlateGray 	         #2F4F4F	 	Оттенки	Смесь
DarkSlateGrey 	         #2F4F4F	 	Оттенки	Смесь
DarkTurquoise 	         #00CED1	 	Оттенки	Смесь
DarkViolet 	             #9400D3	 	Оттенки	Смесь
DeepPink 	               #FF1493	 	Оттенки	Смесь
DeepSkyBlue 	           #00BFFF	 	Оттенки	Смесь
DimGray 	               #696969	 	Оттенки	Смесь
DimGrey 	               #696969	 	Оттенки	Смесь
DodgerBlue 	             #1E90FF	 	Оттенки	Смесь
FireBrick 	             #B22222	 	Оттенки	Смесь
FloralWhite 	           #FFFAF0	 	Оттенки	Смесь
ForestGreen 	           #228B22	 	Оттенки	Смесь
Fuchsia 	               #FF00FF	 	Оттенки	Смесь
Gainsboro 	             #DCDCDC	 	Оттенки	Смесь
GhostWhite 	             #F8F8FF	 	Оттенки	Смесь
Gold 	                   #FFD700	 	Оттенки	Смесь
GoldenRod 	             #DAA520	 	Оттенки	Смесь
Gray 	                   #808080	 	Оттенки	Смесь
Grey 	                   #808080	 	Оттенки	Смесь
Green 	                 #008000	 	Оттенки	Смесь
GreenYellow 	           #ADFF2F	 	Оттенки	Смесь
HoneyDew 	               #F0FFF0	 	Оттенки	Смесь
HotPink 	               #FF69B4	 	Оттенки	Смесь
IndianRed  	             #CD5C5C	 	Оттенки	Смесь
Indigo  	               #4B0082	 	Оттенки	Смесь
Ivory 	                 #FFFFF0	 	Оттенки	Смесь
Khaki 	                 #F0E68C	 	Оттенки	Смесь
Lavender 	               #E6E6FA	 	Оттенки	Смесь
LavenderBlush 	         #FFF0F5	 	Оттенки	Смесь
LawnGreen 	             #7CFC00	 	Оттенки	Смесь
LemonChiffon 	           #FFFACD	 	Оттенки	Смесь
LightBlue 	             #ADD8E6	 	Оттенки	Смесь
LightCoral 	             #F08080	 	Оттенки	Смесь
LightCyan 	             #E0FFFF	 	Оттенки	Смесь
LightGoldenRodYellow 	   #FAFAD2	 	Оттенки	Смесь
LightGray 	             #D3D3D3	 	Оттенки	Смесь
LightGrey 	             #D3D3D3	 	Оттенки	Смесь
LightGreen 	             #90EE90	 	Оттенки	Смесь
LightPink 	             #FFB6C1	 	Оттенки	Смесь
LightSalmon 	           #FFA07A	 	Оттенки	Смесь
LightSeaGreen 	         #20B2AA	 	Оттенки	Смесь
LightSkyBlue 	           #87CEFA	 	Оттенки	Смесь
LightSlateGray 	         #778899	 	Оттенки	Смесь
LightSlateGrey 	         #778899	 	Оттенки	Смесь
LightSteelBlue 	         #B0C4DE	 	Оттенки	Смесь
LightYellow 	           #FFFFE0	 	Оттенки	Смесь
Lime 	                   #00FF00	 	Оттенки	Смесь
LimeGreen 	             #32CD32	 	Оттенки	Смесь
Linen 	                 #FAF0E6	 	Оттенки	Смесь
Magenta 	               #FF00FF	 	Оттенки	Смесь
Maroon 	                 #800000	 	Оттенки	Смесь
MediumAquaMarine 	       #66CDAA	 	Оттенки	Смесь
MediumBlue 	             #0000CD	 	Оттенки	Смесь
MediumOrchid 	           #BA55D3	 	Оттенки	Смесь
MediumPurple 	           #9370DB	 	Оттенки	Смесь
MediumSeaGreen 	         #3CB371	 	Оттенки	Смесь
MediumSlateBlue 	       #7B68EE	 	Оттенки	Смесь
MediumSpringGreen 	     #00FA9A	 	Оттенки	Смесь
MediumTurquoise 	       #48D1CC	 	Оттенки	Смесь
MediumVioletRed 	       #C71585	 	Оттенки	Смесь
MidnightBlue 	           #191970	 	Оттенки	Смесь
MintCream 	             #F5FFFA	 	Оттенки	Смесь
MistyRose 	             #FFE4E1	 	Оттенки	Смесь
Moccasin 	               #FFE4B5	 	Оттенки	Смесь
NavajoWhite 	           #FFDEAD	 	Оттенки	Смесь
Navy 	                   #000080	 	Оттенки	Смесь
OldLace 	               #FDF5E6	 	Оттенки	Смесь
Olive 	                 #808000	 	Оттенки	Смесь
OliveDrab 	             #6B8E23	 	Оттенки	Смесь
Orange 	                 #FFA500	 	Оттенки	Смесь
OrangeRed 	             #FF4500	 	Оттенки	Смесь
Orchid 	                 #DA70D6	 	Оттенки	Смесь
PaleGoldenRod 	         #EEE8AA	 	Оттенки	Смесь
PaleGreen 	             #98FB98	 	Оттенки	Смесь
PaleTurquoise 	         #AFEEEE	 	Оттенки	Смесь
PaleVioletRed 	         #DB7093	 	Оттенки	Смесь
PapayaWhip 	             #FFEFD5	 	Оттенки	Смесь
PeachPuff 	             #FFDAB9	 	Оттенки	Смесь
Peru 	                   #CD853F	 	Оттенки	Смесь
Pink 	                   #FFC0CB	 	Оттенки	Смесь
Plum 	                   #DDA0DD	 	Оттенки	Смесь
PowderBlue 	             #B0E0E6	 	Оттенки	Смесь
Purple 	                 #800080	 	Оттенки	Смесь
RebeccaPurple 	         #663399	 	Оттенки	Смесь
Red 	                   #FF0000	 	Оттенки	Смесь
RosyBrown 	             #BC8F8F	 	Оттенки	Смесь
RoyalBlue 	             #4169E1	 	Оттенки	Смесь
SaddleBrown 	           #8B4513	 	Оттенки	Смесь
Salmon 	                 #FA8072	 	Оттенки	Смесь
SandyBrown 	             #F4A460	 	Оттенки	Смесь
SeaGreen 	               #2E8B57	 	Оттенки	Смесь
SeaShell 	               #FFF5EE	 	Оттенки	Смесь
Sienna 	                 #A0522D	 	Оттенки	Смесь
Silver 	                 #C0C0C0	 	Оттенки	Смесь
SkyBlue 	               #87CEEB	 	Оттенки	Смесь
SlateBlue 	             #6A5ACD	 	Оттенки	Смесь
SlateGray 	             #708090	 	Оттенки	Смесь
SlateGrey 	             #708090	 	Оттенки	Смесь
Snow 	                   #FFFAFA	 	Оттенки	Смесь
SpringGreen 	           #00FF7F	 	Оттенки	Смесь
SteelBlue 	             #4682B4	 	Оттенки	Смесь
Tan 	                   #D2B48C	 	Оттенки	Смесь
Teal 	                   #008080	 	Оттенки	Смесь
Thistle 	               #D8BFD8	 	Оттенки	Смесь
Tomato 	                 #FF6347	 	Оттенки	Смесь
Turquoise 	             #40E0D0	 	Оттенки	Смесь
Violet 	                 #EE82EE	 	Оттенки	Смесь
Wheat 	                 #F5DEB3	 	Оттенки	Смесь
White 	                 #FFFFFF	 	Оттенки	Смесь
WhiteSmoke 	             #F5F5F5	 	Оттенки	Смесь
Yellow 	                 #FFFF00	 	Оттенки	Смесь
YellowGreen 	           #9ACD32	 	Оттенки	Смесь



---------------------------------------------------------------------------------------------------------------------------------------------------------------------------------------------

--------------------
Цвета, стили и тени:
--------------------

---------------------------------------------------------------------------------------------------------------------------------------------------------------------------------------------
Свойство	Описание
---------------------------------------------------------------------------------------------------------------------------------------------------------------------------------------------

fillStyle	                                                 --- Задание или возврат цвета, градиента или узора, используемого для заполнения чертежа
strokeStyle	                                               --- Задание или возврат цвета, градиента или узора, используемого для штрихов
shadowColor	                                               --- Задает или возвращает цвет, используемый для теней
shadowBlur	                                               --- Устанавливает или возвращает уровень размытия для теней
shadowOffsetX	                                             --- Задание или возврат горизонтального расстояния тени от фигуры
shadowOffsetY	                                             --- Задание или возврат вертикального расстояния тени от фигуры



---------------------------------------------------------------------------------------------------------------------------------------------------------------------------------------------
Метод	Описание
---------------------------------------------------------------------------------------------------------------------------------------------------------------------------------------------

createLinearGradient()	                                   --- Создание линейного градиента (для использования в содержимом холста)
createPattern()	                                           --- Повторяет указанный элемент в указанном направлении
createRadialGradient()	                                   --- Создание радиального/кругового градиента (для использования в содержимом холста)
addColorStop()	                                           --- Задает цвета и позиции остановки в объекте градиента



---------------------------------------------------------------------------------------------------------------------------------------------------------------------------------------------

------------
Стили линий:
------------

---------------------------------------------------------------------------------------------------------------------------------------------------------------------------------------------
Свойство	                                                    Описание
---------------------------------------------------------------------------------------------------------------------------------------------------------------------------------------------

lineCap	                                                  --- Задание или возврат стиля концевых колпачков для линии
lineJoin	                                                --- Задает или возвращает тип создаваемого угла, когда две линии встречаются
lineWidth	                                                --- Задает или возвращает текущую ширину строки
miterLimit	                                              --- Задает или возвращает максимальную длину среза



---------------------------------------------------------------------------------------------------------------------------------------------------------------------------------------------

---------------
Прямоугольники:
---------------

---------------------------------------------------------------------------------------------------------------------------------------------------------------------------------------------
Метод	                                                        Описание
---------------------------------------------------------------------------------------------------------------------------------------------------------------------------------------------

rect()	                                                  --- Создание прямоугольника
fillRect()	                                              --- Рисует "заполненный" прямоугольник
strokeRect()	                                            --- Рисует прямоугольник (без заливки)
clearRect()	                                              --- Очищает заданные пикселы в пределах заданного прямоугольника



---------------------------------------------------------------------------------------------------------------------------------------------------------------------------------------------

-----
Пути:
-----

---------------------------------------------------------------------------------------------------------------------------------------------------------------------------------------------
Метод	                                                        Описание
---------------------------------------------------------------------------------------------------------------------------------------------------------------------------------------------

fill()	                                                  --- Заполняет текущий чертеж (путь)
stroke()	                                                --- На самом деле рисует путь, который вы определили
beginPath()	                                              --- Начало пути или сброс текущего пути
moveTo()	                                                --- Перемещение контура в указанную точку на холсте без создания линии
closePath()	                                              --- Создание контура от текущей точки до начальной точки
lineTo()	                                                --- Добавляет новую точку и создает линию к этой точке от последней указанной точки на холсте
clip()	                                                  --- Обрезает область любой формы и размера из исходного полотна
quadraticCurveTo()	                                      --- Создание квадратичной кривой Безье
bezierCurveTo()	                                          --- Создание кубической кривой Безье
arc()	                                                    --- Создание дуги/кривой (используется для создания окружностей или частей окружностей)
arcTo()	                                                  --- Создание дуги/кривой между двумя касательными
isPointInPath()	                                          --- Возвращает значение true, если указанная точка находится в текущем пути, в противном случае false



---------------------------------------------------------------------------------------------------------------------------------------------------------------------------------------------

---------------
Преобразования:
---------------

---------------------------------------------------------------------------------------------------------------------------------------------------------------------------------------------
Метод	                                                        Описание
---------------------------------------------------------------------------------------------------------------------------------------------------------------------------------------------

scale()	                                                  --- Масштабирование текущего чертежа больше или меньше
rotate()	                                                --- Поворот текущего чертежа
translate()	                                              --- Пересопоставление позиции (0,0) на холсте
transform()	                                              --- Заменяет текущую матрицу преобразования для чертежа
setTransform()	                                          --- Сбрасывает текущее преобразование в матрицу удостоверения. Затем запускает transform()



---------------------------------------------------------------------------------------------------------------------------------------------------------------------------------------------

------
Текст:
------

---------------------------------------------------------------------------------------------------------------------------------------------------------------------------------------------
Свойство	                                                    Описание
---------------------------------------------------------------------------------------------------------------------------------------------------------------------------------------------

font	                                                    --- Задает или возвращает текущие свойства шрифта для текстового содержимого
textAlign	                                                --- Задает или возвращает текущую трассу для текстового содержимого
textBaseline	                                            --- Задает или возвращает текущую базовую линию текста, используемую при рисовании текста


---------------------------------------------------------------------------------------------------------------------------------------------------------------------------------------------
Метод	                                                        Описание
---------------------------------------------------------------------------------------------------------------------------------------------------------------------------------------------

fillText()	                                              --- Рисует "заполненный" текст на холсте
strokeText()	                                            --- Рисует текст на холсте (без заливки)
measureText()	                                            --- Возвращает объект, содержащий ширину заданного текста



---------------------------------------------------------------------------------------------------------------------------------------------------------------------------------------------

--------
Рисунок:
--------

---------------------------------------------------------------------------------------------------------------------------------------------------------------------------------------------
Метод	                                                        Описание
---------------------------------------------------------------------------------------------------------------------------------------------------------------------------------------------

drawImage()	                                              --- Рисует изображение, холст или видео на холсте



---------------------------------------------------------------------------------------------------------------------------------------------------------------------------------------------

--------------------------
Манипулирование пикселями:
--------------------------

---------------------------------------------------------------------------------------------------------------------------------------------------------------------------------------------
Свойство	                                                    Описание
---------------------------------------------------------------------------------------------------------------------------------------------------------------------------------------------

width	                                                    --- Возвращает ширину объекта ImageData
height	                                                  --- Возвращает высоту объекта ImageData
data	                                                    --- Возвращает объект, содержащий данные изображения заданного объекта ImageData



---------------------------------------------------------------------------------------------------------------------------------------------------------------------------------------------
Метод	                                                        Описание
---------------------------------------------------------------------------------------------------------------------------------------------------------------------------------------------

createImageData()	                                        --- Создает новый пустой объект ImageData
getImageData()	                                          --- Возвращает объект ImageData, который копирует пиксельные данные для заданного прямоугольника на холсте
putImageData()	                                          --- Помещает данные изображения (из заданного объекта ImageData) обратно на холст



---------------------------------------------------------------------------------------------------------------------------------------------------------------------------------------------

-----------
Композиции:
-----------

---------------------------------------------------------------------------------------------------------------------------------------------------------------------------------------------
Свойство	                                                    Описание
---------------------------------------------------------------------------------------------------------------------------------------------------------------------------------------------

globalAlpha	                                              --- Задание или возврат текущего значения альфа-канала или прозрачности чертежа
globalCompositeOperation	                                --- Задает или возвращает способ рисования нового изображения на существующем изображении



---------------------------------------------------------------------------------------------------------------------------------------------------------------------------------------------

-------
Другое:
-------

---------------------------------------------------------------------------------------------------------------------------------------------------------------------------------------------
Метод	                                                        Описание
---------------------------------------------------------------------------------------------------------------------------------------------------------------------------------------------

save()	                                                  --- Сохраняет состояние текущего контекста
restore()	                                                --- Возвращает ранее сохраненные состояние и атрибуты пути
createEvent()
getContext()
toDataURL()



---------------------------------------------------------------------------------------------------------------------------------------------------------------------------------------------

--------------------------
HTML Аудио и Видео методы:
--------------------------

---------------------------------------------------------------------------------------------------------------------------------------------------------------------------------------------
Метод	                                                        Описание
---------------------------------------------------------------------------------------------------------------------------------------------------------------------------------------------

addTextTrack()	                                          --- Добавление новой текстовой дорожки в аудио/видео
canPlayType()	                                            --- Проверяет, может ли обозреватель воспроизвести указанный тип аудио/видео
load()	                                                  --- Повторная загрузка элемента аудио/видео
play()	                                                  --- Начинает воспроизведение аудио/видео
pause()	                                                  --- Приостанавливает воспроизведение аудио/видео в текущий момент



---------------------------------------------------------------------------------------------------------------------------------------------------------------------------------------------

------------------------------------
Свойства аудио/видео в формате HTML:
------------------------------------

---------------------------------------------------------------------------------------------------------------------------------------------------------------------------------------------
Свойство	                                                    Описание
---------------------------------------------------------------------------------------------------------------------------------------------------------------------------------------------

audioTracks	                                              --- Возвращает объект аудиотракклист, представляющий доступные звуковые дорожки
autoplay	                                                --- Устанавливает или возвращает ли аудио/видео должен начать воспроизведение, как только он загружается
buffered	                                                --- Возвращает объект тимеранжес, представляющий буферизованные части аудио/видео
controller	                                              --- Возвращает объект медиаконтроллер, представляющий текущий контроллер мультимедиа аудио/видео
controls	                                                --- Устанавливает или возвращает ли аудио/видео должны отображать элементы управления (например, воспроизведение/пауза и т.д.)
crossOrigin	                                              --- Задает или возвращает настройки перекрестия аудио/видео
currentSrc	                                              --- Возвращает URL-адрес текущего аудио/видео
currentTime	                                              --- Устанавливает или возвращает текущую позицию воспроизведения в аудио/видео (в секундах)
defaultMuted	                                            --- Устанавливает или возвращает ли аудио/видео должно быть отключено по умолчанию
defaultPlaybackRate	                                      --- Устанавливает или возвращает скорость воспроизведения аудио/видео по умолчанию
duration	                                                --- Возвращает длину текущего аудио/видео (в секундах)
ended	                                                    --- Возвращает значение, закончилось ли воспроизведение аудио/видео
error	                                                    --- Возвращает объект медиаеррор, представляющий состояние ошибки аудио/видео
loop	                                                    --- Устанавливает или возвращает значение, если аудио/видео должно начинаться снова после завершения
mediaGroup	                                              --- Устанавливает или возвращает группу, к которой принадлежит аудио/видео
muted	                                                    --- Задает или возвращает значение, если звук/видео отключен или нет
networkState	                                            --- Возвращает текущее состояние сети аудио/видео
paused	                                                  --- Возвращает значение, если аудио/видео приостановлено или нет
playbackRate	                                            --- Устанавливает или возвращает скорость воспроизведения аудио/видео
played	                                                  --- Возвращает объект тимеранжес, представляющий воспроизводимые части аудио/видео
preload	                                                  --- Устанавливает или возвращает ли аудио/видео должно быть загружено при загрузке страницы
readyState	                                              --- Возвращает текущее состояние готовности аудио/видео
seekable	                                                --- Возвращает объект тимеранжес, представляющий поисковые части аудио/видео
seeking	                                                  --- Возвращает ли пользователь в настоящее время ищет в аудио/видео
src	                                                      --- Устанавливает или возвращает текущий источник аудио/видео элемента
startDate	                                                --- Возвращает объект даты, представляющий текущее смещение времени
textTracks	                                              --- Возвращает объект тексттракклист, представляющий доступные текстовые дорожки
videoTracks	                                              --- Возвращает объект видеотракклист, представляющий доступные видеодорожки
volume	                                                  --- Устанавливает или возвращает громкость аудио/видео



---------------------------------------------------------------------------------------------------------------------------------------------------------------------------------------------

-------------------------
События HTML аудио/видео:
-------------------------

---------------------------------------------------------------------------------------------------------------------------------------------------------------------------------------------
Событие	                                                      Описание
---------------------------------------------------------------------------------------------------------------------------------------------------------------------------------------------

abort	                                                    --- Срабатывает при прерывании загрузки аудио/видео
canplay	                                                  --- Срабатывает, когда браузер может начать воспроизведение аудио/видео
canplaythrough	                                          --- Срабатывает, когда браузер может воспроизводить аудио/видео без остановки для буферизации
durationchange	                                          --- Срабатывает при изменении длительности аудио/видео
emptied	                                                  --- Срабатывает, когда текущий плейлист пуст
ended	                                                    --- Срабатывает при завершении текущего плейлиста
error	                                                    --- Срабатывает, когда произошла ошибка во время загрузки аудио/видео
loadeddata	                                              --- Срабатывает, когда браузер загрузил текущий кадр аудио/видео
loadedmetadata	                                          --- Срабатывает, когда браузер загружает мета-данные для аудио/видео
loadstart	                                                --- Срабатывает, когда браузер начинает искать аудио/видео
pause	                                                    --- Срабатывает, когда аудио/видео было приостановлено
play	                                                    --- Срабатывает, когда аудио/видео было запущено или больше не приостановлено
playing	                                                  --- Срабатывает при воспроизведении аудио/видео после паузы или остановки для буферизации
progress	                                                --- Срабатывает, когда браузер загружает аудио/видео
ratechange	                                              --- Срабатывает при изменении скорости воспроизведения аудио/видео
seeked	                                                  --- Срабатывает, когда пользователь завершает перемещение/пропуск на новую позицию в аудио/видео
seeking	                                                  --- Срабатывает, когда пользователь начинает перемещение/пропуск на новую позицию в аудио/видео
stalled	                                                  --- Срабатывает, когда обозреватель пытается получить данные мультимедиа, но данные недоступны
suspend	                                                  --- Срабатывает, когда обозреватель преднамеренно не получает данные мультимедиа
timeupdate	                                              --- Срабатывает при изменении текущей позиции воспроизведения
volumechange	                                            --- Срабатывает при изменении тома
waiting	                                                  --- Срабатывает, когда видео останавливается, потому что он должен буфер следующий кадр



---------------------------------------------------------------------------------------------------------------------------------------------------------------------------------------------



---------------------------------------------------------------------------------------------------------------------------------------------------------------------------------------------

-------------------------------
Элементы HTML и Valid DOCTYPES:
-------------------------------

---------------------------------------------------------------------------------------------------------------------------------------------------------------------------------------------
Тег	              HTML5	          Transitional	  Strict	        Frameset	      XHTML 1.1
---------------------------------------------------------------------------------------------------------------------------------------------------------------------------------------------

<a>	              Да	            Да	            Да	            Да	            Да
---------------------------------------------------------------------------------------------------------------------------------------------------------------------------------------------
<abbr>	          Да	            Да	            Да	            Да	            Да
---------------------------------------------------------------------------------------------------------------------------------------------------------------------------------------------
<acronym>	        Нет	            Да	            Да	            Да	            Да
---------------------------------------------------------------------------------------------------------------------------------------------------------------------------------------------
<address>       	Да	            Да	            Да	            Да	            Да
---------------------------------------------------------------------------------------------------------------------------------------------------------------------------------------------
<applet>	        Нет	            Да	            Нет	            Да	            Нет
---------------------------------------------------------------------------------------------------------------------------------------------------------------------------------------------
<area>	          Да	            Да	            Да	            Да	            Нет
---------------------------------------------------------------------------------------------------------------------------------------------------------------------------------------------
<article>	        Да	            Нет	            Нет	            Нет	            Нет
---------------------------------------------------------------------------------------------------------------------------------------------------------------------------------------------
<aside>	          Да	            Нет	            Нет	            Нет	            Нет
---------------------------------------------------------------------------------------------------------------------------------------------------------------------------------------------
<audio>	          Да	            Нет	            Нет	            Нет	            Нет
---------------------------------------------------------------------------------------------------------------------------------------------------------------------------------------------
<b>	              Да	            Да	            Да	            Да	            Да
---------------------------------------------------------------------------------------------------------------------------------------------------------------------------------------------
<base>	          Да	            Да	            Да	            Да	            Да
---------------------------------------------------------------------------------------------------------------------------------------------------------------------------------------------
<basefont>	      Нет	            Да	            Нет	            Да	            Нет
---------------------------------------------------------------------------------------------------------------------------------------------------------------------------------------------
<bdi>	            Да	            Нет	            Нет	            Нет	            Нет
---------------------------------------------------------------------------------------------------------------------------------------------------------------------------------------------
<bdo>	            Да	            Да	            Да	            Да	            Нет
---------------------------------------------------------------------------------------------------------------------------------------------------------------------------------------------
<big>	            Нет	            Да	            Да	            Да	            Да
---------------------------------------------------------------------------------------------------------------------------------------------------------------------------------------------
<blockquote>	    Да	            Да	            Да	            Да	            Да
---------------------------------------------------------------------------------------------------------------------------------------------------------------------------------------------
<body>	          Да	            Да	            Да	            Да	            Да
---------------------------------------------------------------------------------------------------------------------------------------------------------------------------------------------
<br>	            Да	            Да	            Да	            Да	            Да
---------------------------------------------------------------------------------------------------------------------------------------------------------------------------------------------
<button>	        Да	            Да	            Да	            Да	            Да
---------------------------------------------------------------------------------------------------------------------------------------------------------------------------------------------
<canvas>	        Да	            Нет	            Нет	            Нет	            Нет
---------------------------------------------------------------------------------------------------------------------------------------------------------------------------------------------
<caption>	        Да	            Да	            Да	            Да	            Да
---------------------------------------------------------------------------------------------------------------------------------------------------------------------------------------------
<center>	        Нет	            Да	            Нет	            Да	            Нет
---------------------------------------------------------------------------------------------------------------------------------------------------------------------------------------------
<cite>	          Да	            Да	            Да	            Да	            Да
---------------------------------------------------------------------------------------------------------------------------------------------------------------------------------------------
<code>	          Да	            Да	            Да	            Да	            Да
---------------------------------------------------------------------------------------------------------------------------------------------------------------------------------------------
<col>	            Да	            Да	            Да	            Да	            Нет
---------------------------------------------------------------------------------------------------------------------------------------------------------------------------------------------
<colgroup>	      Да	            Да	            Да	            Да	            Нет
---------------------------------------------------------------------------------------------------------------------------------------------------------------------------------------------
<datalist>	      Да	            Нет	            Нет	            Нет	            Нет
---------------------------------------------------------------------------------------------------------------------------------------------------------------------------------------------
<dd>	            Да	            Да	            Да	            Да	            Да
---------------------------------------------------------------------------------------------------------------------------------------------------------------------------------------------
<del>	            Да	            Да	            Да	            Да	            Нет
---------------------------------------------------------------------------------------------------------------------------------------------------------------------------------------------
<details>	        Да	            Нет	            Нет	            Нет	            Нет
---------------------------------------------------------------------------------------------------------------------------------------------------------------------------------------------
<dfn>	            Да	            Да	            Да	            Да	            Да
---------------------------------------------------------------------------------------------------------------------------------------------------------------------------------------------
<dialog>	        Да	            Нет	            Нет	            Нет	            Нет
---------------------------------------------------------------------------------------------------------------------------------------------------------------------------------------------
<dir>	            Нет	            Да	            Нет	            Да	            Нет
---------------------------------------------------------------------------------------------------------------------------------------------------------------------------------------------
<div>	            Да	            Да	            Да	            Да	            Да
---------------------------------------------------------------------------------------------------------------------------------------------------------------------------------------------
<dl>	            Да	            Да	            Да	            Да	            Да
---------------------------------------------------------------------------------------------------------------------------------------------------------------------------------------------
<dt>	            Да	            Да	            Да	            Да	            Да
---------------------------------------------------------------------------------------------------------------------------------------------------------------------------------------------
<em>	            Да	            Да	            Да	            Да	            Да
---------------------------------------------------------------------------------------------------------------------------------------------------------------------------------------------
<embed>	          Да	            Нет	            Нет	            Нет	            Нет
---------------------------------------------------------------------------------------------------------------------------------------------------------------------------------------------
<fieldset>	      Да	            Да	            Да	            Да	            Да
---------------------------------------------------------------------------------------------------------------------------------------------------------------------------------------------
<figcaption>	    Да	            Нет	            Нет	            Нет	            Нет
---------------------------------------------------------------------------------------------------------------------------------------------------------------------------------------------
<figure>	        Да	            Нет	            Нет	            Нет	            Нет
---------------------------------------------------------------------------------------------------------------------------------------------------------------------------------------------
<font>	          Нет	            Да	            Нет	            Да	            Нет
---------------------------------------------------------------------------------------------------------------------------------------------------------------------------------------------
<footer>	        Да	            Нет	            Нет	            Нет	            Нет
---------------------------------------------------------------------------------------------------------------------------------------------------------------------------------------------
<form>	          Да	            Да	            Да	            Да	            Да
---------------------------------------------------------------------------------------------------------------------------------------------------------------------------------------------
<frame>	          Нет	            Нет	            Нет	            Да	            Нет
---------------------------------------------------------------------------------------------------------------------------------------------------------------------------------------------
<frameset>	      Нет	            Нет	            Нет	            Да	            Нет
---------------------------------------------------------------------------------------------------------------------------------------------------------------------------------------------
<h1> to <h6>	    Да	            Да	            Да	            Да	            Да
---------------------------------------------------------------------------------------------------------------------------------------------------------------------------------------------
<head>	          Да	            Да	            Да	            Да	            Да
---------------------------------------------------------------------------------------------------------------------------------------------------------------------------------------------
<header>	        Да	            Нет	            Нет	            Нет	            Нет
---------------------------------------------------------------------------------------------------------------------------------------------------------------------------------------------
<hr>	            Да	            Да	            Да	            Да	            Да
---------------------------------------------------------------------------------------------------------------------------------------------------------------------------------------------
<html>	          Да	            Да	            Да	            Да	            Да
---------------------------------------------------------------------------------------------------------------------------------------------------------------------------------------------
<i>	              Да	            Да	            Да	            Да	            Да
---------------------------------------------------------------------------------------------------------------------------------------------------------------------------------------------
<iframe>	        Да	            Да	            Нет	            Да	            Нет
---------------------------------------------------------------------------------------------------------------------------------------------------------------------------------------------
<img>	            Да	            Да	            Да	            Да	            Да
---------------------------------------------------------------------------------------------------------------------------------------------------------------------------------------------
<input>	          Да	            Да	            Да	            Да	            Да
---------------------------------------------------------------------------------------------------------------------------------------------------------------------------------------------
<ins>	            Да	            Да	            Да	            Да	            Нет
---------------------------------------------------------------------------------------------------------------------------------------------------------------------------------------------
<kbd>	            Да	            Да	            Да	            Да	            Да
---------------------------------------------------------------------------------------------------------------------------------------------------------------------------------------------
<label>	          Да	            Да	            Да	            Да	            Да
---------------------------------------------------------------------------------------------------------------------------------------------------------------------------------------------
<legend>	        Да	            Да	            Да	            Да	            Да
---------------------------------------------------------------------------------------------------------------------------------------------------------------------------------------------
<li>	            Да	            Да	            Да	            Да	            Да
---------------------------------------------------------------------------------------------------------------------------------------------------------------------------------------------
<link>	          Да	            Да	            Да	            Да	            Да
---------------------------------------------------------------------------------------------------------------------------------------------------------------------------------------------
<main>	          Да	            Нет	            Нет	            Нет	            Нет
---------------------------------------------------------------------------------------------------------------------------------------------------------------------------------------------
<map>	            Да	            Да	            Да	            Да	            Нет
---------------------------------------------------------------------------------------------------------------------------------------------------------------------------------------------
<mark>	          Да	            Нет	            Нет	            Нет	            Нет
---------------------------------------------------------------------------------------------------------------------------------------------------------------------------------------------
<menu>	          Да	            Да	            Нет	            Да	            Нет
---------------------------------------------------------------------------------------------------------------------------------------------------------------------------------------------
<menuitem>	      Да	            Нет	            Нет	            Нет	            Нет
---------------------------------------------------------------------------------------------------------------------------------------------------------------------------------------------
<meta>	          Да	            Да	            Да	            Да	            Да
---------------------------------------------------------------------------------------------------------------------------------------------------------------------------------------------
<meter>	          Да	            Нет	            Нет	            Нет	            Нет
---------------------------------------------------------------------------------------------------------------------------------------------------------------------------------------------
<nav>	            Да	            Нет	            Нет	            Нет	            Нет
---------------------------------------------------------------------------------------------------------------------------------------------------------------------------------------------
<noframes>	      Нет	            Да	            Нет	            Да	            Нет
---------------------------------------------------------------------------------------------------------------------------------------------------------------------------------------------
<noscript>	      Да	            Да	            Да	            Да	            Да
---------------------------------------------------------------------------------------------------------------------------------------------------------------------------------------------
<object>	        Да	            Да	            Да	            Да	            Да
---------------------------------------------------------------------------------------------------------------------------------------------------------------------------------------------
<ol>	            Да	            Да	            Да	            Да	            Да
---------------------------------------------------------------------------------------------------------------------------------------------------------------------------------------------
<optgroup>	      Да	            Да	            Да	            Да	            Да
---------------------------------------------------------------------------------------------------------------------------------------------------------------------------------------------
<option>	        Да	            Да	            Да	            Да	            Да
---------------------------------------------------------------------------------------------------------------------------------------------------------------------------------------------
<output>	        Да	            Нет	            Нет	            Нет	            Нет
---------------------------------------------------------------------------------------------------------------------------------------------------------------------------------------------
<p>	              Да	            Да	            Да	            Да	            Да
---------------------------------------------------------------------------------------------------------------------------------------------------------------------------------------------
<param>	          Да	            Да	            Да	            Да	            Да
---------------------------------------------------------------------------------------------------------------------------------------------------------------------------------------------
<pre>	            Да	            Да	            Да	            Да	            Да
---------------------------------------------------------------------------------------------------------------------------------------------------------------------------------------------
<progress>	      Да	            Нет	            Нет	            Нет	            Нет
---------------------------------------------------------------------------------------------------------------------------------------------------------------------------------------------
<q>	              Да	            Да	            Да	            Да	            Да
---------------------------------------------------------------------------------------------------------------------------------------------------------------------------------------------
<rp>	            Да	            Нет	            Нет	            Нет	            Нет
---------------------------------------------------------------------------------------------------------------------------------------------------------------------------------------------
<rt>	            Да	            Нет	            Нет	            Нет	            Нет
---------------------------------------------------------------------------------------------------------------------------------------------------------------------------------------------
<ruby>	          Да	            Нет	            Нет	            Нет	            Нет
---------------------------------------------------------------------------------------------------------------------------------------------------------------------------------------------
<s>	              Да	            Да	            Нет	            Да	            Нет
---------------------------------------------------------------------------------------------------------------------------------------------------------------------------------------------
<samp>	          Да	            Да	            Да	            Да	            Да
---------------------------------------------------------------------------------------------------------------------------------------------------------------------------------------------
<script>	        Да	            Да	            Да	            Да	            Да
---------------------------------------------------------------------------------------------------------------------------------------------------------------------------------------------
<section>	        Да	            Нет	            Нет	            Нет	            Нет
---------------------------------------------------------------------------------------------------------------------------------------------------------------------------------------------
<select>	        Да	            Да	            Да	            Да	            Да
---------------------------------------------------------------------------------------------------------------------------------------------------------------------------------------------
<small>	          Да	            Да	            Да	            Да	            Да
---------------------------------------------------------------------------------------------------------------------------------------------------------------------------------------------
<source>	        Да	            Нет	            Нет	            Нет	            Нет
---------------------------------------------------------------------------------------------------------------------------------------------------------------------------------------------
<span>	          Да	            Да	            Да	            Да	            Да
---------------------------------------------------------------------------------------------------------------------------------------------------------------------------------------------
<strike>	        Нет	            Да	            Нет	            Да	            Нет
---------------------------------------------------------------------------------------------------------------------------------------------------------------------------------------------
<strong>	        Да	            Да	            Да	            Да	            Да
---------------------------------------------------------------------------------------------------------------------------------------------------------------------------------------------
<style>	          Да	            Да	            Да	            Да	            Да
---------------------------------------------------------------------------------------------------------------------------------------------------------------------------------------------
<sub>	            Да	            Да	            Да	            Да	            Да
---------------------------------------------------------------------------------------------------------------------------------------------------------------------------------------------
<summary>	        Да	            Нет	            Нет	            Нет	            Нет
---------------------------------------------------------------------------------------------------------------------------------------------------------------------------------------------
<sup>	            Да	            Да	            Да	            Да	            Да
---------------------------------------------------------------------------------------------------------------------------------------------------------------------------------------------
<table>	          Да	            Да	            Да	            Да	            Да
---------------------------------------------------------------------------------------------------------------------------------------------------------------------------------------------
<tbody>	          Да	            Да	            Да	            Да	            Нет
---------------------------------------------------------------------------------------------------------------------------------------------------------------------------------------------
<td>	            Да	            Да	            Да	            Да	            Да
---------------------------------------------------------------------------------------------------------------------------------------------------------------------------------------------
<textarea>	      Да	            Да	            Да	            Да	            Да
---------------------------------------------------------------------------------------------------------------------------------------------------------------------------------------------
<tfoot>	          Да	            Да	            Да	            Да	            Нет
---------------------------------------------------------------------------------------------------------------------------------------------------------------------------------------------
<th>	            Да	            Да	            Да	            Да	            Да
---------------------------------------------------------------------------------------------------------------------------------------------------------------------------------------------
<thead>	          Да	            Да	            Да	            Да	            Нет
---------------------------------------------------------------------------------------------------------------------------------------------------------------------------------------------
<time>	          Да	            Нет	            Нет	            Нет	            Нет
---------------------------------------------------------------------------------------------------------------------------------------------------------------------------------------------
<title>	          Да	            Да	            Да	            Да	            Да
---------------------------------------------------------------------------------------------------------------------------------------------------------------------------------------------
<tr>	            Да	            Да	            Да	            Да	            Да
---------------------------------------------------------------------------------------------------------------------------------------------------------------------------------------------
<track>	          Да	            Нет	            Нет	            Нет	            Нет
---------------------------------------------------------------------------------------------------------------------------------------------------------------------------------------------
<tt>	            Нет	            Да	            Да	            Да	            Да
---------------------------------------------------------------------------------------------------------------------------------------------------------------------------------------------
<u>	              Да	            Да	            Нет	            Да	            Нет
---------------------------------------------------------------------------------------------------------------------------------------------------------------------------------------------
<ul>	            Да	            Да	            Да	            Да	            Да
---------------------------------------------------------------------------------------------------------------------------------------------------------------------------------------------
<var>	            Да	            Да	            Да	            Да	            Да
---------------------------------------------------------------------------------------------------------------------------------------------------------------------------------------------
<video>	          Да	            Нет	            Нет	            Нет	            Нет
---------------------------------------------------------------------------------------------------------------------------------------------------------------------------------------------
<wbr>	            Да	            Нет	            Нет	            Нет	            Нет
---------------------------------------------------------------------------------------------------------------------------------------------------------------------------------------------





---------------------------------------------------------------------------------------------------------------------------------------------------------------------------------------------

---------------------------
HTTP Сообщения о состоянии:
---------------------------

---------------------------------------------------------------------------------------------------------------------------------------------------------------------------------------------
1xx: Информация

Сообщение:	                                                  Описание:
---------------------------------------------------------------------------------------------------------------------------------------------------------------------------------------------

100 Continue	                                            --- Сервер получил заголовки запроса, и клиент должен приступить к отправке тела запроса
101 Switching Protocols	                                  --- Инициатор запроса попросил сервер переключить протоколы
103 Checkpoint	                                          --- Используется в предложении возобновляемых запросов для возобновления прерванных запросов PUT или POST



---------------------------------------------------------------------------------------------------------------------------------------------------------------------------------------------





---------------------------------------------------------------------------------------------------------------------------------------------------------------------------------------------
2xx: Успешной

Сообщение:	                                                 Описание:
---------------------------------------------------------------------------------------------------------------------------------------------------------------------------------------------

200 OK	                                                 --- Запрос одобрен (это стандартный ответ на успешные HTTP-запросы)
201 Created	                                             --- Запрос выполнен, и новый ресурс создан
202 Accepted	                                           --- Запрос принят к обработке, но обработка не завершена
203 Non-Authoritative Information	                       --- Запрос успешно обработан, но возвращает информацию, которая может быть из другого источника
204 No Content	                                         --- Запрос успешно обработан, но не возвращает содержимое
205 Reset Content	                                       --- Запрос успешно обработан, но не возвращает никакого содержимого и требует, чтобы инициатор запроса сбросил представление документа
206 Partial Content	                                     --- Сервер доставляет только часть ресурса из-за заголовка диапазона, отправленного клиентом


---------------------------------------------------------------------------------------------------------------------------------------------------------------------------------------------





---------------------------------------------------------------------------------------------------------------------------------------------------------------------------------------------
3xx: Перенаправление

Сообщение:	                                                 Описание:
---------------------------------------------------------------------------------------------------------------------------------------------------------------------------------------------

300 Multiple Choices	                                   --- Список ссылок. Пользователь может выбрать ссылку и перейти к этому Расположение. Максимум пять адресов
301 Moved Permanently	                                   --- Запрошенная страница перенесена на новый URL-адрес
302 Found	                                               --- Запрошенная страница временно перешла на новый URL-адрес
303 See Other	                                           --- Запрашиваемая страница может быть найдена под другим URL
304 Not Modified	                                       --- Указывает, что запрошенная страница не была изменена с момента последнего запроса
306 Switch Proxy	                                       --- Больше не используется
307 Temporary Redirect	                                 --- Запрошенная страница временно перешла на новый URL-адрес
308 Resume Incomplete	                                   --- Используется в предложении возобновляемых запросов для возобновления прерванных запросов PUT или POST



---------------------------------------------------------------------------------------------------------------------------------------------------------------------------------------------






---------------------------------------------------------------------------------------------------------------------------------------------------------------------------------------------
4xx: Ошибка клиента

Сообщение:	                                                 Описание:
---------------------------------------------------------------------------------------------------------------------------------------------------------------------------------------------

400 Bad Request	                                         --- Запрос не может быть выполнен из-за плохого синтаксиса
401 Unauthorized	                                       --- Запрос был юридическим запросом, но сервер отказывается отвечать на него. Для использования, когда Аутентификация возможна
402 Payment Required	                                   --- Зарезервировано для использования в будущем
403 Forbidden	                                           --- Запрос был юридическим запросом, но сервер отказывается отвечать на него
404 Not Found	                                           --- Запрошенная страница не найдена, но может быть снова доступна в будущем
405 Method Not Allowed	                                 --- Запрос был сделан из страницы с помощью метода запроса, не поддерживаемого этой страницей
406 Not Acceptable	                                     --- Сервер может генерировать только ответ, который не принимается клиентом
407 Proxy Authentication Required	                       --- Клиент должен сначала проверить себя с помощью прокси-сервера
408 Request Timeout	                                     --- Время ожидания сервера в ожидании запроса
409 Conflict	                                           --- Запрос не может быть завершен из-за конфликта в запросе
410 Gone	                                               --- Запрашиваемая страница больше не доступна
411 Length Required	"Content-Length" не определен.       --- Сервер не будет принимать запрос без него
412 Precondition Failed	                                 --- Предварительное условие, заданное в запросе, оценено как false по сервер
413 Request Entity Too Large	                           --- Сервер не примет запрос, так как сущность Request является слишком большой
414 Request-URI Too Long	                               --- Сервер не примет запрос, так как URL-адрес слишком долго. Происходит при преобразовании запроса POST в запрос GET
415 Unsupported Media Type	                             --- Сервер не примет запрос, так как носитель тип не поддерживается
416 Requested Range Not Satisfiable	                     --- Клиент запросил часть файла, но сервер не может предоставить эту часть
417 Expectation Failed	                                 --- Сервер не может выполнить требования поля заголовка Expect-запроса



---------------------------------------------------------------------------------------------------------------------------------------------------------------------------------------------





---------------------------------------------------------------------------------------------------------------------------------------------------------------------------------------------
5xx: Ошибка сервера

Сообщение:	                                                Описание:
---------------------------------------------------------------------------------------------------------------------------------------------------------------------------------------------

500 Internal Server Error	                              --- Общее сообщение об ошибке, если не подходит более конкретное сообщение
501 Not Implemented	                                    --- Сервер либо не распознает метод запроса, либо ему не хватает возможности выполнить запрос
502 Bad Gateway	                                        --- Сервер действовал в качестве шлюза или прокси и получил неверный ответ от вышестоящего сервера
503 Service Unavailable	                                --- Сервер в настоящее время недоступен (перегружен или выключен)
504 Gateway Timeout	                                    --- Сервер действовал в качестве шлюза или прокси и не получал своевременного ответа от вышестоящего сервера
505 HTTP Version Not Supported	                        --- Сервер не поддерживает версию протокола HTTP, используемую в запросе
511 Network Authentication Required	                    --- Клиент должен пройти проверку подлинности для получения доступа к сети



---------------------------------------------------------------------------------------------------------------------------------------------------------------------------------------------




--------------------------
HTTP Методы: GET vs. POST:
--------------------------

---------------------------------------------------------------------------------------------------------------------------------------------------------------------------------------------
Сравнить GET vs. POST

action                                                 GET	                                                                     POST
---------------------------------------------------------------------------------------------------------------------------------------------------------------------------------------------

Кнопка возврата/перезагрузка	                         Безвредны	                                                               Данные будут повторно отправлены
Закладка	                                             Можно закладка	                                                           Не может быть Закладка
Кэшированные	                                         Может кэшироваться	                                                       Не кэшируется
Тип кодировки	                                         application/x-www-form-urlencoded	                                       application/x-www-form-urlencoded or multipart/form-data.
Истории	                                               Параметры остаются в журнале обозревателя	                               Параметры не сохраняются в журнале обозревателя
Ограничения по длине данных	                           Да  	                                                                     Без ограничений
Ограничения типа данных	                               Разрешены только символы ASCII	Никаких ограничений.                       Двоичные данные также разрешены
Безопасности	                                         Get менее безопасен по сравнению с POST                                   POST немного безопаснее, чем Get
Видимость	                                             Данные видны всем в URL	                                                 Данные не отображаются в URL-адресе



---------------------------------------------------------------------------------------------------------------------------------------------------------------------------------------------

----------------------------
Другие методы HTTP-запросов:
----------------------------

---------------------------------------------------------------------------------------------------------------------------------------------------------------------------------------------
Метод	                                                 Описание
---------------------------------------------------------------------------------------------------------------------------------------------------------------------------------------------

HEAD	                                             --- То же, что и Get, но возвращает только заголовки HTTP и не тело документа
PUT	                                               --- Загружает представление заданного URI
DELETE	                                           --- Удаляет указанный ресурс
OPTIONS	                                           --- Возвращает HTTP-методы, поддерживаемые сервером
CONNECT	                                           --- Преобразует подключение запроса к прозрачному туннелю TCP/IP



---------------------------------------------------------------------------------------------------------------------------------------------------------------------------------------------





---------------------------------------------------------------------------------------------------------------------------------------------------------------------------------------------

------------------------
Конвертер пикселей в EM:
------------------------

------------------------------
px	      em	      percent
------------------------------

5px	    0.3125em	  31.25%
------------------------------
6px	    0.3750em	  37.50%
------------------------------
7px	    0.4375em	  43.75%
------------------------------
8px	    0.5000em	  50.00%
------------------------------
9px	    0.5625em	  56.25%
------------------------------
10px	  0.6250em	  62.50%
------------------------------
11px	  0.6875em	  68.75%
------------------------------
12px	  0.7500em	  75.00%
------------------------------
13px	  0.8125em	  81.25%
------------------------------
14px	  0.8750em	  87.50%
------------------------------
15px	  0.9375em	  93.75%
------------------------------
16px	  1.0000em	  100.00%
------------------------------
17px	  1.0625em	  106.25%
------------------------------
18px	  1.1250em	  112.50%
------------------------------
19px	  1.1875em	  118.75%
------------------------------
20px	  1.2500em	  125.00%
------------------------------
21px	  1.3125em	  131.25%
------------------------------
22px	  1.3750em	  137.50%
------------------------------
23px	  1.4375em	  143.75%
------------------------------
24px	  1.5000em	  150.00%
------------------------------
25px	  1.5625em	  156.25%
------------------------------



---------------------------------------------------------------------------------------------------------------------------------------------------------------------------------------------






---------------------------------------------------------------------------------------------------------------------------------------------------------------------------------------------

-----------------
Сочетания клавиш:
-----------------

---------------------------------------------------------------------------------------------------------------------------------------------------------------------------------------------
Описание	                                 Windows	                                 Mac OS
---------------------------------------------------------------------------------------------------------------------------------------------------------------------------------------------

Меню "Правка"	                             Alt + E	                                 Ctrl + F2 + F
Меню "файл"	                               Alt + F	                                 Ctrl + F2 + E
Меню "вид"	                               Alt + V	                                 Ctrl + F2 + V
Выделить весь текст	                       Ctrl + A	                                 Cmd + A
Копировать текст	                         Ctrl + C	                                 Cmd + C
Поиск текста	                             Ctrl + F	                                 Cmd + F
Поиск и замена текста	                     Ctrl + H	                                 Cmd + F
Новый документ	                           Ctrl + N	                                 Cmd + N
Открытие файла	                           Ctrl + O	                                 Cmd + O
Параметры печати	                         Ctrl + P	                                 Cmd + P
Сохранить файл	                           Ctrl + S	                                 Cmd + S
Вставить текст	                           Ctrl + V	                                 Cmd + V
Вырезать текст	                           Ctrl + X	                                 Cmd + X
Повторить текст	                           Ctrl + Y	                                 Shift + Cmd + Z
Отменить текст	                           Ctrl + Z	                                 Cmd + Z



---------------------------------------------------------------------------------------------------------------------------------------------------------------------------------------------





---------------------------------------------------------------------------------------------------------------------------------------------------------------------------------------------

----------------------
Редактирование текста:
----------------------

--------------------
Перемещение курсора:
--------------------

---------------------------------------------------------------------------------------------------------------------------------------------------------------------------------------------
Описание	                                                   Windows	                                                   Mac OS
---------------------------------------------------------------------------------------------------------------------------------------------------------------------------------------------

Переход вправо или в начало следующего разрыва строки	       Стрелка вправо	                                             Стрелка вправо
Переход к левому или к концу предыдущего разрыва строки	     Стрелка влево	                                             Стрелка влево
Перейти на одну строку вверх	                               Стрелка вверх	                                             Стрелка вверх
Спуститься на одну строку вниз	                             Стрелка вниз	                                               Стрелка вниз
Переход к началу текущей строки	                             Home	                                                       Cmd + стрелка влево
Переход к концу текущей строки	                             End	                                                       Cmd + стрелка вправо
Переход к началу документа	                                 Ctrl + Home	                                               Cmd + Стрелка вверх
Перейти в конец документа	                                   Ctrl + End	                                                 Cmd + Down Arrow
Переход на один кадр вверх	                                 Page Up	                                                   Fn + Стрелка вверх
Переместить вниз на одну рамку	                             Page Down	                                                 Fn + Стрелка вниз
Перейти к началу предыдущего слова	                         Ctrl + стрелка влево	                                       Option + Стрелка влево
Перейти к началу следующего слова	                           Ctrl + Стрелка вправо	                                     Option + Стрелка вправо
Перейти к началу разрыва строки	                             Ctrl + стрелка вверх	                                       Cmd + стрелка влево
Перейти к концу разрыва строки	                             Ctrl + стрелка вниз	                                       Cmd + стрелка вправо



---------------------------------------------------------------------------------------------------------------------------------------------------------------------------------------------





---------------------------------------------------------------------------------------------------------------------------------------------------------------------------------------------

Выделение текста

---------------------------------------------------------------------------------------------------------------------------------------------------------------------------------------------
Описание	                                                    Windows	                                                    Mac OS
---------------------------------------------------------------------------------------------------------------------------------------------------------------------------------------------

Выделение символов слева	                                    Shift + стрелка влево	                                      Shift + стрелка влево
Выбор знаков справа	                                          Shift + стрелка вправо	                                    Shift + стрелка вправо
Выбрать линии вверх	                                          Shift + стрелка вверх	                                      Shift + стрелка вверх
Выбрать линии вниз	                                          Shift + стрелка вниз	                                      Shift + стрелка вниз
Выделение слов слева	                                        Shift + Ctrl + влево	                                      Shift + Opt + влево
Выберите слова справа	                                        Shift + Ctrl + вправо	                                      Shift + Opt + вправо
Выделение абзацев слева	                                      Shift + Ctrl + Up	                                          Shift + ОПТ + up
Выделение абзацев вправо	                                    Shift + Ctrl + вниз	                                        Shift + ОПТ + вниз
Выделение текста между курсором и началом текущей строки	    Shift + Home	                                              Cmd + Shift + стрелка влево
Выделение текста между курсором и концом текущей строки	      Сдвиг + конец	                                              Cmd + Shift + стрелка вправо
Выделение текста между курсором и началом документа	          Shift + Ctrl + Home	                                        Cmd + Shift + стрелка вверх
Выделение текста между курсором и концом документа	          Shift + Ctrl + End	                                        Cmd + Shift + стрелка вниз
Выделение одного кадра во время текста над курсором	          Shift + Page Up	                                            Shift + Fn + Стрелка вверх
Выделение одного кадра в момент текста под курсором	          Shift + Page Down	                                          Shift + Fn + Down Arrow
Выделить весь текст	                                          Ctrl + A	                                                  Cmd + A
Поиск текста	                                                Ctrl + F	                                                  Cmd + F


---------------------------------------------------------------------------------------------------------------------------------------------------------------------------------------------





---------------------------------------------------------------------------------------------------------------------------------------------------------------------------------------------

Форматирование текста

---------------------------------------------------------------------------------------------------------------------------------------------------------------------------------------------
Описание	                                                     Windows	                                                     Mac OS
---------------------------------------------------------------------------------------------------------------------------------------------------------------------------------------------

Сделать выделенный текст полужирным	                           Ctrl + B	                                                     Cmd + B
Выделить выделенный текст курсивом	                           Ctrl + I	                                                     Cmd + I
Подчеркивание выделенного текста	                             Ctrl + U	                                                     Cmd + U
Сделать выделенный текстовый индекс	                           Ctrl + Shift + =	                                             Cmd + Shift + =
Сделать выбранный текст подстрочным	                           Ctrl + =	                                                     Cmd + =


---------------------------------------------------------------------------------------------------------------------------------------------------------------------------------------------





---------------------------------------------------------------------------------------------------------------------------------------------------------------------------------------------

Редактирование текста

---------------------------------------------------------------------------------------------------------------------------------------------------------------------------------------------
Описание	                                                     Windows	                                                     Mac OS
---------------------------------------------------------------------------------------------------------------------------------------------------------------------------------------------

Удалить символы слева	                                         Backspace	                                                   Backspace
Удаление знаков вправо	                                       Delete	                                                       Fn + Backspace
Удалить слова вправо	                                         Ctrl + Del	                                                   Cmd + Backspace
Удалить слова слева	                                           Ctrl + Backspace	                                             Cmd + Fn + Backspace
Отступ	                                                       Tab	                                                         Tab
Табуляция	                                                     Shift + Tab	                                                 Shift + Tab
Копировать текст	                                             Ctrl + C	                                                     Cmd + C
Поиск и замена текста	                                         Ctrl + H	                                                     Cmd + F
Вставить текст	                                               Ctrl + V	                                                     Cmd + V
Вырезать текст	                                               Ctrl + X	                                                     Cmd + X
Повторить текст	                                               Ctrl + Y	                                                     Shift + Cmd + Z
Отменить текст	                                               Ctrl + Z	                                                     Cmd + Z


---------------------------------------------------------------------------------------------------------------------------------------------------------------------------------------------





---------------------------------------------------------------------------------------------------------------------------------------------------------------------------------------------

-------------
Веб-браузеры:
-------------
----------
Навигации:
----------

---------------------------------------------------------------------------------------------------------------------------------------------------------------------------------------------
Описание	                                                      Windows	                                                      Mac OS
---------------------------------------------------------------------------------------------------------------------------------------------------------------------------------------------

Прокрутите рамку вниз	                                          Space or Page Down	                                          Space or Fn + Down Arrow
Прокрутка вверх по кадру	                                      Shift + Space or Page Up	                                    Shift + Space or Fn + Up Arrow
Перейти к нижней части страницы	                                End	                                                          Cmd + Down Arrow
Перейти к началу страницы	                                      Home	                                                        Cmd + Up Arrow
Вернуться	                                                      Alt + Left Arrow or Backspace	                                Cmd + Left Arrow
Идти вперед	                                                    Alt + Right Arrow or Shift + Backspace	                      Cmd + Right Arrow
Обновление веб-страницы	                                        F5	                                                          Cmd + R
Обновление веб-страницы (без кэша)	                            Ctrl + F5	                                                    Cmd + Shift + R
Остановить	                                                    Esc	                                                          Esc
Переключение во весь экран	                                    F11	                                                          Cmd + Shift + F
Увеличить	                                                      Ctrl + +	                                                    Cmd + +
Уменьшить	                                                      Ctrl + -	                                                    Cmd + -
Увеличить 100% (по умолчанию)	                                  Ctrl + 0	                                                    Cmd + 0
Открыть домашнюю страницу	                                      Alt + Home	                                                  Option + Home or Option + Fn + Left Arrow
Поиск текста	                                                  Ctrl + F	                                                    Cmd + F


---------------------------------------------------------------------------------------------------------------------------------------------------------------------------------------------






---------------------------------------------------------------------------------------------------------------------------------------------------------------------------------------------

------------------------
Tab / Window Management:
------------------------

---------------------------------------------------------------------------------------------------------------------------------------------------------------------------------------------
Описание	                                                      Windows	                                                      Mac OS
---------------------------------------------------------------------------------------------------------------------------------------------------------------------------------------------

Открыть новую вкладку	                                          Ctrl + T	                                                    Cmd + T
Закрыть текущую вкладку	                                        Ctrl + W	                                                    Cmd + W
Закрыть все вкладки	                                            Ctrl + Shift + W	                                            Cmd + Q
Закрытие всех вкладок, кроме текущей вкладки	                  Ctrl + Alt + F4	                                              Cmd + Opt + W
Перейти к следующей вкладке	                                    Ctrl + Tab	                                                  Control + Tab or Cmd + Shift + Right Arrow
Перейти к предыдущей вкладке	                                  Ctrl + Shift + Tab	                                          Shift + Control + Tab or Cmd + Shift + Left Arrow
Переход к определенному номеру вкладки	                        Ctrl + 1-8	                                                  Cmd + 1-8
Перейти к последней вкладке	                                    Ctrl + 9	                                                    Cmd + 9
Повторное открытие последней закрытой вкладки	                  Ctrl + Shift + T	                                            Cmd + Shift + T
Открыть новое окно	                                            Ctrl + N	                                                    Cmd + N
Закрыть текущее окно	                                          Alt + F4	                                                    Cmd + W
Перейти к следующему окну	                                      Alt + Tab	                                                    Cmd + Tab
Перейти к предыдущему окну	                                    Alt + Shift + Tab	                                            Cmd + Shift + Tab
Повторное открытие последнего закрытого окна	                  Ctrl + Shift + N
Открытие ссылок в новой вкладке в фоновом режиме	              Ctrl + Click	                                                Cmd + Click
Открытие ссылок в новой вкладке на переднем плане	              Ctrl + Shift + Click	                                        Cmd + Shift + Click
Печать текущей веб-страницы	                                    Ctrl + P	                                                    Cmd + P
Сохранить текущую веб-страницу	                                Ctrl + S	                                                    Cmd + S


---------------------------------------------------------------------------------------------------------------------------------------------------------------------------------------------





---------------------------------------------------------------------------------------------------------------------------------------------------------------------------------------------

----------------
Адресная строка:
----------------

---------------------------------------------------------------------------------------------------------------------------------------------------------------------------------------------
Описание	                                                        Windows	                                                        Mac OS
---------------------------------------------------------------------------------------------------------------------------------------------------------------------------------------------

Циклический цикл между панелью инструментов, панелью поиска	      Tab	                                                            Tab
Перейти в адресную строку обозревателя	                          Ctrl + L or Alt + D	                                            Cmd + E / Cmd + K
Открытие местоположения адресной строки на новой вкладке	        Alt + Enter	                                                    Opt + Enter
Отображение списка ранее введенных адресов	                      F4  Ctrl + Enter	                                              Cmd + Enter or Control + Enter


---------------------------------------------------------------------------------------------------------------------------------------------------------------------------------------------






---------------------------------------------------------------------------------------------------------------------------------------------------------------------------------------------

---------
Закладки:
---------

---------------------------------------------------------------------------------------------------------------------------------------------------------------------------------------------
Описание	                                                        Windows	                                                        Mac OS
---------------------------------------------------------------------------------------------------------------------------------------------------------------------------------------------

Открытие меню закладок	                                          Ctrl + B	                                                      Cmd + B
Добавить закладку для текущей страницы	                          Ctrl + D	                                                      Cmd + Opt + B or Cmd + Shift + B
Открыть журнал просмотра	                                        Ctrl + H	                                                      Cmd + Shift + H or Cmd + Y
Открыть журнал загрузок	                                          Ctrl + J	                                                      Cmd + J or Cmd + Shift + J


---------------------------------------------------------------------------------------------------------------------------------------------------------------------------------------------






---------------------------------------------------------------------------------------------------------------------------------------------------------------------------------------------

----------
Скриншоты:
----------

---------------------------------------------------------------------------------------------------------------------------------------------------------------------------------------------
Описание	                                                        Windows	                                                        Mac OS
---------------------------------------------------------------------------------------------------------------------------------------------------------------------------------------------

Сохранить скриншот всего экрана в виде файла	 	                                                                                  Cmd + Shift + 3
Копировать скриншот всего экрана в буфер обмена	                  PrtScr (Экран печати) or Ctrl + PrtScr	                        Cmd + Ctrl + Shift + 3
Сохранить скриншот окна в виде файла	 	                                                                                          Cmd + Shift + 4, then Space
Копировать скриншот окна в буфер обмена	                          Alt + PrtScr	                                                  Cmd + Ctrl + Shift + 4, then Space
Копировать скриншот желаемой области в буфер обмена		                                                                            Cmd + Ctrl + Shift + 4
Сохранить скриншот желаемой области в виде файла	 	                                                                              Cmd + Shift + 4



---------------------------------------------------------------------------------------------------------------------------------------------------------------------------------------------
